노화의 생물학	생명과학
이것이 취업을 위한 코딩 테스트다	정보/통신
팀 개발을 위한 Git, GitHub 시작하기	정보/통신
(R, JAGS, Stan을 이용한) 베이지안 데이터 분석 바이블	정보/통신
(고디스) 역학	보건의료
바이오파이썬으로 만나는 생물정보학	생명과학
파이썬 웹 프로그래밍	정보/통신
파이썬으로 웹 크롤러 만들기	정보/통신
파이썬 데이터 사이언스 핸드북	정보/통신
유닉스 이론과 실습	정보/통신
노화의 종말	문학
식물과학의 이해	생명과학
유전체 데이터 분석 2	생명과학
언어와 언어학	언어
유전체데이터분석1	생명과학
쉽게 배우는 자료구조 with 파이썬	정보/통신
데이터 과학을 위한 통계	수학
데이터베이스 for Beginner	정보/통신
쉽게 배우는 운영체제	정보/통신
캠벨 생명과학 11판	생명과학
처음 배우는 데이터 과학	정보/통신
파이썬을 활용한 생명정보학	생명과학
파이썬을 활용한 베이지안 통계	수학
생명정보학 알고리즘 파이썬으로 구현하는 생명정보학 알고리즘	생명과학
컴퓨팅 사고력을 키우는 이산수학	수학
생물정보학 알고리듬	생명과학
파이썬을 이용한 비트코인 자동매매	경제/경영
데이터 과학을 위한 파이썬 머신러닝	정보/통신
진화적 분석	생명과학
식물 유전자, 유전체 그리고 유전학	생명과학
데이터 과학을 위한 파이썬 프로그래밍	정보/통신
데이터베이스 개론	정보/통신
파이썬 증권 데이터 분석	경제/경영
대학물리학 10판	물리학
식물학	생명과학
난생처음 R 코딩 & 데이터 분석	정보/통신
모두를 위한 R 데이터 분석 입문	정보/통신